KEGG_TAURINE_AND_HYPOTAURINE_METABOLISM	Substance metabolism
KEGG_LINOLEIC_ACID_METABOLISM	Lipid?metabolism
KEGG_ETHER_LIPID_METABOLISM	Lipid?metabolism
KEGG_ARACHIDONIC_ACID_METABOLISM	Lipid?metabolism
KEGG_GLYCEROPHOSPHOLIPID_METABOLISM	Lipid?metabolism
KEGG_HEDGEHOG_SIGNALING_PATHWAY	Signaling pathway
KEGG_FC_EPSILON_RI_SIGNALING_PATHWAY	Signaling pathway
KEGG_CELL_ADHESION_MOLECULES_CAMS	CAMs
KEGG_PENTOSE_PHOSPHATE_PATHWAY	Glycometabolism
KEGG_GLYCOLYSIS_GLUCONEOGENESIS	Glycometabolism
KEGG_FRUCTOSE_AND_MANNOSE_METABOLISM	Glycometabolism
KEGG_GALACTOSE_METABOLISM	Glycometabolism
KEGG_STARCH_AND_SUCROSE_METABOLISM	Glycometabolism
KEGG_PENTOSE_AND_GLUCURONATE_INTERCONVERSIONS	Glycometabolism
KEGG_PYRIMIDINE_METABOLISM	Substance metabolism
KEGG_STEROID_HORMONE_BIOSYNTHESIS	Substance metabolism
KEGG_DRUG_METABOLISM_OTHER_ENZYMES	Substance metabolism
KEGG_PORPHYRIN_AND_CHLOROPHYLL_METABOLISM	Substance metabolism
KEGG_ASCORBATE_AND_ALDARATE_METABOLISM	Substance metabolism
KEGG_OXIDATIVE_PHOSPHORYLATION	Energy?generation
KEGG_CITRATE_CYCLE_TCA_CYCLE	Energy?generation
KEGG_P53_SIGNALING_PATHWAY	Signaling pathway
KEGG_NOD_LIKE_RECEPTOR_SIGNALING_PATHWAY	Signaling pathway
KEGG_PPAR_SIGNALING_PATHWAY	Signaling pathway
KEGG_ADIPOCYTOKINE_SIGNALING_PATHWAY	Signaling pathway
KEGG_UBIQUITIN_MEDIATED_PROTEOLYSIS	Protein
KEGG_PROTEIN_EXPORT	Protein
KEGG_PROTEASOME	Protein
KEGG_NUCLEOTIDE_EXCISION_REPAIR	Nucleotide repair
KEGG_MISMATCH_REPAIR	Nucleotide repair
KEGG_BASE_EXCISION_REPAIR	Nucleotide repair
KEGG_SPLICEOSOME	Proliferation
KEGG_CELL_CYCLE	Proliferation
KEGG_DNA_REPLICATION	Proliferation
